  S x  x x
x  x  x xx
x   x   xx
xx  x  xxx
xx        
xx    Fxxx